70
20
╔════════════════════════════════════════════════════════════════════╗
║                                           │     ┃                  ║
║                                           │     ┃                  ║
║                                           │     ┃                  ║
║                                           │     ┃                  ║
║                                           │     ┃                  ║
╠═══════════════════════════════            │     ┃                  ║
║                                           │     ┃   /              ║
║                                           │     ┃  /               ║
║                                                 ┃ /                ║
║                /┃                               ┃/                 ║
║               / ┃                                                  ║
║              /  ┃    │                                             ║
║             /   ┃    │                                             ║
║                 ┃    │              ═══════════════════════════════╣
║                 ┃    │                                             ║
║                 ┃    │                                             ║
║                 ┃    │                                             ║
║                 ╿    │                                             ║
╚═════════════════╧════╧═════════════════════════════════════════════╝
